1111111111
1002212111
1012020211
1201210111
1202220211
1001210211
1002020011
1001020011
1001010011
1111111111