1111111111
1100100001
1000100001
1000111121
1000210001
1000200001
1211100001
1000100111
1000100111
1111111111